{
    "meta": {
        "title": "Test"
    },

    "player": {
        "start": {"x": 6, "y": 2},
        "dir": {"x": 0, "y": 1}
    },

    "textures": [
        {"id": 0,   "name": "data/img/air.png"},
        {"id": 8,   "name": "data/img/red_brick_wall/top_border02.png"}
    ],

    "map": {
        "level": [
            [0, 0, 0, 0, 8, 8, 8, 8, 8, 0, 0, 0, 0, 0, 0, 0],
            [0, 0, 0, 0, 8, 0, 0, 0, 8, 0, 0, 0, 0, 0, 0, 0],
            [0, 0, 0, 0, 8, 0, 0, 0, 8, 0, 0, 0, 0, 0, 0, 0],
            [0, 0, 0, 0, 8, 0, 0, 0, 8, 0, 0, 0, 0, 0, 0, 0],
            [0, 0, 0, 0, 8, 0, 0, 0, 8, 0, 0, 0, 0, 0, 0, 0],
            [0, 0, 0, 0, 8, 8, 0, 8, 8, 0, 0, 0, 0, 0, 0, 0],
            [0, 0, 0, 0, 8, 0, 0, 0, 8, 0, 0, 0, 0, 0, 0, 0],
            [0, 0, 0, 0, 8, 0, 0, 0, 8, 0, 0, 0, 0, 0, 0, 0],
            [0, 0, 0, 0, 8, 0, 0, 0, 8, 0, 0, 0, 0, 0, 0, 0],
            [0, 0, 0, 0, 8, 0, 0, 0, 8, 0, 0, 0, 0, 0, 0, 0],
            [0, 0, 0, 0, 8, 0, 0, 0, 8, 0, 0, 0, 0, 0, 0, 0],
            [0, 0, 0, 0, 8, 0, 0, 0, 8, 0, 0, 0, 0, 0, 0, 0],
            [0, 0, 0, 0, 8, 0, 0, 0, 8, 0, 0, 0, 0, 0, 0, 0],
            [0, 0, 0, 0, 8, 8, 0, 8, 8, 0, 0, 0, 0, 0, 0, 0],
            [0, 0, 0, 0, 0, 8, 0, 8, 0, 0, 0, 0, 0, 0, 0, 0],
            [0, 0, 0, 8, 8, 8, 0, 8, 0, 0, 0, 0, 0, 0, 0, 0],
            [0, 0, 0, 8, 0, 0, 0, 8, 0, 0, 0, 0, 0, 0, 0, 0],
            [0, 0, 0, 8, 0, 8, 0, 8, 8, 8, 0, 0, 0, 0, 0, 0],
            [0, 0, 0, 8, 0, 8, 0, 0, 0, 8, 8, 8, 8, 8, 8, 8],
            [0, 0, 0, 8, 0, 8, 8, 8, 0, 8, 0, 0, 0, 0, 0, 8],
            [0, 0, 0, 8, 0, 8, 0, 8, 0, 0, 0, 0, 0, 0, 0, 8],
            [0, 0, 0, 8, 0, 8, 8, 8, 0, 8, 0, 0, 0, 0, 0, 8],
            [0, 0, 0, 8, 0, 0, 0, 0, 0, 8, 8, 0, 8, 8, 8, 8],
            [0, 0, 0, 8, 0, 8, 0, 8, 8, 8, 8, 0, 8, 0, 0, 0],
            [8, 8, 8, 8, 0, 8, 0, 8, 0, 0, 8, 0, 8, 0, 0, 0],
            [8, 0, 0, 0, 0, 8, 0, 8, 0, 8, 8, 0, 8, 8, 8, 8],
            [8, 0, 0, 0, 0, 8, 0, 8, 0, 8, 0, 0, 0, 0, 0, 8],
            [8, 0, 0, 0, 0, 0, 0, 8, 0, 8, 0, 0, 0, 0, 0, 8],
            [8, 0, 0, 0, 0, 8, 0, 8, 8, 8, 0, 0, 0, 0, 0, 8],
            [8, 0, 0, 0, 0, 8, 0, 0, 0, 0, 0, 8, 8, 8, 8, 8],
            [8, 8, 8, 8, 0, 8, 0, 0, 0, 0, 0, 8, 0, 0, 0, 0],
            [0, 0, 0, 8, 0, 0, 0, 0, 0, 0, 0, 8, 0, 0, 0, 0],
            [0, 0, 0, 0, 8, 8, 0, 0, 0, 0, 0, 8, 0, 0, 0, 0],
            [0, 0, 0, 0, 0, 8, 0, 0, 0, 0, 0, 8, 0, 0, 0, 0],
            [0, 0, 0, 0, 0, 8, 8, 8, 8, 8, 8, 8, 0, 0, 0, 0]
        ],

        "sprites": [
        ],

        "tileEntities": [
        ],

        "entities": [
        ]
    }
}
